     R   1080 1024

NO ./textures/bluestone.xpm

SO ./textures/colorstone.xpm
WE ./textures/greystone.xpm
EA        ./textures/redbrick.xpm

S ./textures/barrel.xpm

F 124,    142, 12

     C     12, 220,    125

1111
1N01
1111
