            R               1200       900

                S ./textures/barrel.xpm

NO                    ./textures/colorstone.xpm
           SO             ./textures/bluestone.xpm
                       WE                      ./textures/eagle.xpm
            EA ./textures/redbrick.xpm
F      220,100,2
            C                       225,30,            8

11111111111111111111111111111
10000000000000000000000000001
10000000000000000000000000001
10000000000000000000000000001
10000000022222222220000000001
10000000000000000020000000001
10000000000000000020000000001111111
11111111111100W0002000000000001111111111
1000000000000000011111111111111
100000000000000000200000000011111111111111111111111111
10000000022220022220000000001
10000000000000000000000000001
10000000000011111000000000001
1000000000001  10000000000001
10000000000011111000000000001
10000000000000000000000000001                   11111
 11111111111111111111111000111111111111111111111111001
                        100000000000011111111111110011
                        10000000000000000020000000001
                        10000000022220022220000000001
                        10000000000000000000000000001
                        10000000000000000000000000001
                        10000000000000000000000000001
                        10000000000000000000000000001
                        10000000000000000000000000001
                        11111111111111111111111111111

11111111111
100000000001
111111111111